
#############################
                            #
#    #######         ####   #
#                           #
#########     #####         #
#                        ####
#                           #
####      ############      #
#                           #
#############               # 
#                     #######
#                           #
#                  ####     #
#                            
#############################
