
#############################
[                           #
#    #######         ####   #
#                           #
#########!    #####         #
#                        ####
#                           #
####      ############      #
#                           #
#############           !   #
#                     #######
#                           #
#                  ####     #
#                           ]
#############################
