#############################
[       #                   #
#    #######   ###   #####  #
#                #          #
#######################     #
#    #                   ####
#         #######   ###     #
####            #  #     ####
#       #                   #
##### #######   #####       #
#                  #  #######
#    ###############        #
#                  ####  ####
#!        #####             ]
#############################