#############################
[                           #
#                           #
#                           #
#                           #
#############    ############
#                           #
#############    ############
#                           #
#############    ############
#                           #
#                           #
#                           #
#                           #
#############################