#############################
[                           #
#    #######         ####   #
#                &          #
#########!    #####         #
#                        ####
#                           #
####      ############      #
#                           #
#############           !   #
#                     #######
#                           #
# &                ####     #
#                           ]
#############################